Keywords,Facebook ,Twitter,Instagram,Blogs ,Reviews,All
Nike,1823,1495,1504,1572,1775,8169
Adidas,1905,1695,1576,1710,1730,8616
Puma,1327,1565,1097,1787,1809,7585
Fila,1278,1623,1630,1454,1081,7066
Champion,1694,1374,1249,1616,1506,7439
Vans,1802,1912,1849,1555,1205,8323
Timberland,1198,1831,1375,1963,1798,8165
Underarmour,1744,1531,1802,1333,1431,7841
CGS,1578,1024,1763,1524,1823,7712
CalvinKlein,1610,1157,1676,1188,1307,6938
